22222222222222
21111111111112
21111111111112
21111111111112
21111111111112
21111111111112
21111111111112
21111111131112
21111111111112
21111111111112
21111111111112
21111111111112
21111111111112
21111111111112
22222222222222