22222222222222
21111111111112
21111111111112
21111111111112
21111111111112
21111111111112
21111111111112
21111131111112
21111111111112
21111111111112
21111111111112
21111111111112
21111111111112
21111111111112
22222222222222